ウエイター	waiter
おじいさん	grandfather; old man
お宅	おたく	(someone's) house/home
大人	おとな	adult
外国語	がいこくご	foreign language
楽器	がっき	musical instrument
空手	からて	karate
カレー	curry
着物	きもの	kimono
ケーキ	cake
広告	こうこく	advertisement
紅茶	こうちゃ	black tea
言葉	ことば	language
ゴルフ	golf
セーター	sweater
像	ぞう	elephant
バイオリン	violin
バイク	motorbike
物価	ぶっか	consumer prices
文法	ぶんぽう	grammar
弁護士	べんごし	lawyer
募集	ぼしゅう	recruitment
店	みせ	store
やくざ	gangster
約束	やくそく	promise; appointment
レポート	term paper
私	わたくし	I (formal)
うれしい	glad
悲しい	かなしい	sad
辛い	からい	hot and spicy; salty
厳しい	きびしい	strict
近い	ちかい	close; near
いろいろ（な）	various; different kinds of
幸せ	しあわせ（な）	lasting happiness
だめ（な）	no good
編む	あむ	to knit
貸す	かす	to lend; to rent
頑張る	がんばる	to do one's best; to try hard
泣く	なく	to cry
磨く	みがく	to brush teeth; to polish
約束を守る	やくそくをまもる	to keep a promise
感動する	かんどうする	to be moved/touched by
いらっしゃいます	(honorable) someone is present/home
～回	～かい	~times
～キロ	~kilometers; ~kilograms
実は	じつは	as a matter of fact...
全部	ぜんぶ	all
～と申します	～ともうします	my name is...
よろしくお願いします	よろしくおねがいします	Thank you (in advance)
一日	いちにち	one day
二日	ふつか	two days
三日	みっか	three days
四日	よっか	four days
五日	いつか	five days
六日	むいか	six days
七日	なのか	seven days
八日	ようか	eight days
九日	ここのか	nine days
十日	とおか	ten days