兄	あに	(my) older brother
大家さん	おおやさん	landlord
お返し	おかえし	return (as a token of gratitude)
奥さん	おくさん	(your/his) wife
おじさん	uncle; middle-aged man
おばさん	aunt; middle-aged woman
クラブ	club; student society
クリスマス	Christmas
ご主人	ごしゅじん	(your/her) husband
コップ	tumbler; glass
皿	さら	plate; dish
時間	じかん	time
チョコレート	chocolate
電子メール	でんしメール	e-mail
ぬいぐるみ	stuffed animal (e.g. teddy bear)
ネクタイ	necktie
母	はは	(my) mother
バレンタインデー	St. Valentine's Day
ビデオカメラ	camcorder
夫婦	ふうふ	married couple; husband and wife
ホワイトデー	"White Day" (yet another gift-giving day)
マフラー	winter scarf
漫画	まんが	comic book
マンション	multistory apartment; condominium
みかん	mandarin
指輪	ゆびわ	ring
ラジオ	radio
両親	りょうしん	parents
履歴書	りれきしょ	resume
欲しい	ほしい	to want
けち（な）	stingy; cheap
送る	おくる	to send
似合う	にあう	to look good (on somebody)
あきらめる	to give up
あげる	to give (to others)
くれる	to give (me)
できる	to come into existance; to be made
相談する	そうだんする	to consult
プロポーズする	to propose marriage
同じ	おなじ	same
去年	きょねん	last year
～君	～くん	Mr./Ms. (casual)
こんな～	...like this; this kind of...
～たち	(makes noun plural)
私たち	わたしたち	we
ちょうど	exactly
よく	well
～個	～こ	counter for smaller items
～冊	～さつ	counter for bound volumes
～台	～だい	counter for equipment
～匹	～ひき	counter for smaller animals
～本	～ほん	counter for long objects